------T-------------------o----B--------------|---------------------B--------o--------------T-----ET--?-E-|---?-B-----|--B--------?--o------------|--------E-X--B---------------T----------X-----EX-B---
---|-E----|--X------E-E---o-B---o--E-----|--X-B------o--M-|------T-------------E--TB-----|-----------M-------o-----------o-o-ET--X-BB-----------o-|---T-----X--X--E-E--E--E----|--------o--E-----B------
---------------T-----M----T-----------M------------B----o-----M-ETM--B-----------------o---?-------M-----------X-B-------X------M--------?----To--X----|----?-------B---T--?---o----T----E----M?--------
--T--E-X----E---E----B---?---------?------o---|------------------------M-----T--X--E--|---T-----?T--|--?-----T------------Eo-M--------------------B-B----------------------E-----------------B?---XX----
-E--XE-----------------B---EE-o-o--------|------o?--|--E-T?EE-----------------|----X-M---M-----X|-------M----MM-----------------X--o--o----X--------|B-----E------M-E----E------------|------M---M--T---
--oo--------M-------o----?T--|---------?-------------T--M------------------|---B----E--------?X--------------M-T--------------B-----|---------------T-------B--B-----o--B----M---?-------------------TB-
------------|--B----B---------------------E-?--?-----o-T--------M?-B------------------TT---------|---E-----------?----?--------------------------------|EB-|----?E-B|-o------E-|----o----------?-----T--
------oX-X-o--M---M-----E-|------M|-------------X----?-------B------o----B-------------B----o|-M--------?-----E-oM?-----------M------MM------E-----|------------M-B-|------------E---------------|-----v
-----E--------------|---------E-X----M------------?--oT-B-----X-------M-----o--?-------B-----------T--M--o|---------o---o------o----M---T-----|-----E------B----------M---?-----------X--X----E--------f
-----|----?-------------------------?--o----------------E------o----------o-o----------------B--M-----B--Eo-------------X-------E---------o|--X--E-----------|---?--------E---------E------X---o-M-----f
---|B--??--------------M--E------|---------E--------o-----------E--M--E-------?--------B-----------?-o-------|-T---B---X----------------|---T--|--E-------?----------X---B-----?-----o-T---------------f
---------T--B--?--------o-------|--------o-B?----------------------X--E------B-------T-T----T---oM------XX-----------BM------E---B--T----------|------M--?|---|---------X--M-?--|--B--o------?-----o---f
--?---------|-----|---EE-------B--------X-??-----------M--M--|-------------------?T-----X----o-----X---?-----X----------o----E------M---T------M-|-------T-X-M--E-T-------T------M------------T|--B--|-f
-----M-----E---------X--T---o|--?--M--------M--------------------E----?---|-------M------------|----|-M----------?--B-E----o--BX-------E---------?-----T--------E--------------E--------|-?-?X---------f
m----T-|---M---o-----------------------------BMo?---TT--o-------B---------------------oM--B-------?-----X------M-o------M--------------?---?-----B-B-------T--BoT-----|---------------------X------?---X
XXXXXXXXXXXXXXXXXXXXXXXXX?XXXXXXEXXXXXXXXXXXXXXXXXXXXXXXXXXXXX|XXXXXXTXXXXXXXXXXBXXXXXXXXXXXXXXXXXXXXXXXX?XXXXXXXBXXXXXXXXXXXXXXXXXXXXXXXXXXX-XXXXXXX?XXXXXXXXXXXXXXXXXXXXXXXXXXXXXXXXXXXXXXXXXXXXXXXXXX
