--?-------------------------B--M----|-X--o---------------TT-|-----MT-B-----E--XB-X--o------TX---------X----X-T---E--X-----B---------E|-----T?-------MoEXM-|-|-------B----------B-X-TE------------?X---T-
---o-------|-----B-------?T-------------o-|--E-------?B-------|-----o---B---------o-------------------BE------B------------o--------Xo-o--T-----?----------TB---X---TE----T?---?-E----|M-----M-B|----B|-
--o--|o---?-X|-M--|X--B----B---|--B--E----B------X--MT------------|------T----EX-------E-|-------oXMo-----------X-X---|-------M-------------oB--B-X-?-------------T-----M-------T--|---TT--?------------
---o---B---|--o----E-T----------------?--------E?----------?------?----------B---------------------M-T--|-E-----o-B-|-X-----------E---X-T-M---------X----?--o---------------X---------oo-----Eo---------
--E--------M----o-o-o-M-?----B-----------?---------X-XM-----BX--E------------------------------o------T--?-M-------oT-o----B---oo-----|---|------o---B---XB---------M---B------X---------|--------B---|-
-T-X-----------M-M-o---M-----?X-E-o--TM-B--B------M|---------------o----T--o----To---?--M----E|-T--E-B-------MT--------|MT--------|--B-o----|B---MBX|---T---------BT-|------T--B-----M--B---------E---B-
------B-T-M-B------------o-BEMM--------?---|--?------------------------------T-E?-----oT---E---?-|E-------------B--o--B---------E-|---X----B-M---o-------?|--|------|---M---X------?|-EX-----------E?---
-B---------T--|o|?--E---------o---M-|---X----E------------M--M---T--E-----------E-?----E--E--B----B------------B--B--?-B--|--B----B------X----B-------M-B-E-------|o------M-----|--B------T------E-EM--v
-----------oT----------------X?---?-------|B----------------o-M---|---------T-B------?M-|?-T----E------M----------------MB---------------M-?-----X-------o--------o--X---------B---|-?X----BT------X---f
--|-MM--M-??---------?-------|X?-X--M-T-E--?---MM----M------MM-------MoMX--X---TM-----oT--------?--|X-X-----|------------|------------------------|---------?-----------------------TX--M-|--ME--------f
------------------------BMT--X----------E--E-----E---M|-------E----|-----------X-------T---?-T-TE--oET|-----M--oo---T-E----------------MT--E-------B---T---------?-------------oB---------------?ME--|-f
---XMM-------M--T-?---B--------M?---------o-E-B-----To----oBoB-?-B?B--??----------XT?---E--X-M-----|-----M-----X-------Bo-----M-?-------|----X-X--?||--X-----------|B-?-E|---MM--?----o--------X--o----f
------X-TE--E-X-E-----------TBT-----|X----TT----------T-X-------E-------o----B----M---------MX---------o--------TB?-o-|------o-o------------?----E--------X-o----M-?--o------------B---MX--|---------T-f
--T---|----E--M----M-T-----oM-TE----?-o--T---B-B----MB?---M?--?o-B--T----M--TX--o---M-----------o-----|--T-----------X--T---EXT----B---XE-----B-----------?------T----B-EM---T--??-----E-----T|--M|----f
m--T----MT-----|o--B----X-M--------E-------E|--o----M--B---o--------X----B|-----oB--B---|------X-----TX|------X-----B-------?-MBX-----M--M--------?|E|T--------XBB-----------B?X---|-MBTE--X--B---T----X
XXXXXXXXXXXXXXXXXXXXXXXXX|XXXXXXXXX|XXXXXX-XXoXXXXXXXBXXXXXXXXXXXXXXXXXXXXXXTXXXXXXXXXXXXXXX?XoXXXXXXXTXX|X-XXXXXXXXXXXXXXXEX-XoXXXXXXXXXXXXXXXXXXXXXXXXXXXXXXXXXXXoXXXXXXXXXXXXXX?XXXXXXXTXXXXXXXX-XXXX
